R 640 480
F 96,64,32
C 64,255,255
SO ./wall.xpm

1111111 11111
1000101 10001
10S0001 10001
1000101 10001
1111101 11111
1000001
1111111
