R 1280 960
F 96,64,32
C 64,255,255
S ./torch.xpm
SO ./wall.xpm
WE ./wall.xpm
NO ./wall.xpm
EA ./wall.xpm

1111111 11111
1200101 10001
12W0001 10201
1200101 10001
1111101111011
100000000001
111111111111
