R 640 480
F 96,64,32
C 64,255,255
S ./torch.xpm
SO ./wall.xpm
WE ./wall.xpm
NO ./wall.xpm
EA ./wall.xpm

1111111 11111
1200101 10001
12N0001 10201
1200101 10001
1111101 11111
1000001
1111111
