R 600 400
F 127,127,127
C 0,127,255
SO ./mick.xpm

1111111 11111
1000101 10001
10S0001 10001
1000101 10001
1111101 11111
1000001
1111111
